111111111111111
1C0000CC00000C1
1000111001C0011
1P001E100CCCC01
111111111111111