1111111111111111
1C1000CCCC0000C1
11101010001C0011
1P001E1000CCCC01
1111111111111111