1111111111111111
1C0000CCCC0000C1
10001010001C0011
1P001E1000CCCC01
1111111111111111