111111111
1010000C1
100011001
1P011E001
111111111
