111111111111111111111111111111
1C0000CCCC00C111111C0000000C11
10001010000100000001C110000111
100010100101000000011111000001
1P001E1000000011C1100000000001
1C0000CCCC000111111C0001000C11
100010100001000000001110000111
1C0000C1CC100110C11C0000000011
1000101000010000000110100C0001
1C00C00CCC000111111C0000000011
10001010000100001C00111001C111
111111111111111111111111111111