111111111
1100000E1
1C0000011
1P0001C11
111111111
