1111111
10C0001
1000111
1P000E1
1111111
