111111111
1100000E1
1C0000001
1P0001C11
111111111
